9 6
110111
110111
100011
111000
111011
110001
110101
100101
111111